

NO ./texture/texture_north.xpm
SO               						    ./texture/texture_south.xpm

F      220,100,0
C 225,       30,0


gptnpigntg


WE ./texture/texture_west.xpm
EA ./texture/texture_east.xpm

1111111111
1001001001
1000000001
1000000101      111111
1000N00001111111100001
1000000000000000000001
1000000001111111100001
1100000011      111111
1000001001
1010101001
1010111001
1111111111