

NO ./path_to_north
SO               						    ./path_to_south

F      220,100,0
C 225,       30,0


gptnpigntg


WE ./path_to_west
EA ./path_to_east

1111111111                     10000001
11110N1101                     11111111
1000000001                     10000001
111111011111111111111111111111111110111
100000000000000000000000000000000000001
111111111111111111111111111111111111101
100000000000000000000000000000000000001
111111111111111111111111111111111111101
100000000000000000000000000000000000001
111111111111111111111111111111111111110