

WE ./texture/texture_west.xpm



EA               						    ./texture/texture_west.xpm
PISTOL0 ./texture/gun.xpm
PISTOL1 ./texture/feu.xpm
PISTOL2 ./texture/recul1.xpm
PISTOL3 ./texture/recul2.xpm

F     112,    128,144
C 56,    64,72


gptnpigntg


NO ./texture/light_wall.xpm
SO ./texture/light_wall.xpm

                                  111111111111111111
                                  100000000000000001
      111111        111111111111111000000000000000011111
      100001        100000000000001000000000000000010001
      1000001       100000000000003000000000000000000001
      1000001       100000000000001000000000000000010001
      1111131111111 100011111111111000000000000000011111
      1000000000001 10001         100000000000000001
      100000000000111000111       11111111311111111
      100000000000100000001             10001
      100000000000000000001             10001
      100000000000100000001             10001
111111100000000000111111111             10001
1000111000000000001                     11311
1000111111131111111                111111000111
1000111111000111111                1000030000001
11311    10001                     100001000111
10001    10001                     1000010001
10001    10001                     1000010001
10001    11311                     1111110001
10001111110001                     1111111011                    11111111111
10001000010001             111111111111111311111111111111        10000000001
10003000010001             100000000000000000000000000001        10000000001
10001000010001             100000000000000000000000000001        10000000001
1000111110000111111        1000000000000000000000000000011111111110000000001
1000100000000000001        1000000000000000000000000000030000000010000000001
1000100000000000001        1000000000000000000000000000010000000030000000001
1000100000000000001        1000000000000000000000000000010000000011111111111
1000300000000000001        111111111111111311111111111111111001111
1000100000000000001                     10001              1001
1000100000000000001                     10001              1001
1000100000000000001                     10001              1001
1000111111131111111                     10001              1001111111111111111
1000311111000111111                     10001              1000001010101010101
1000111111000111111                     10001              1000003000000000001
100011111113111111111111111      111111111311111111        1000001010101010101
100000000000000000000000001111   100000010001000001        1111111111111111111
100000000000000000000000003001   100000030003000001
100000000000000000000000001001   111111110001111111
111111111111111111111111111111111100000030003000001
                                 100N00010001000001
                                 111111110001111111
                                 100000000000000001
                                 100000000000000001
                                 111111111111111111
