

NO ./texture/texture_north.xpm
SO               						    ./texture/texture_south.xpm

F      220,100,0
C 225,       30,0


gptnpigntg


WE ./texture/texture_west.xpm
EA ./texture/texture_east.xpm

11111111
10000001
10000001
10000001
100N0001
10000101
10101011
11111111