

NO ./texture/texture_north.xpm
SO               						    ./texture/texture_south.xpm
PISTOL0 ./texture/gun.xpm
PISTOL1 ./texture/feu.xpm
PISTOL2 ./texture/recul1.xpm
PISTOL3 ./texture/recul2.xpm

F      220,100,0
C 225,       30,0


gptnpigntg


WE ./texture/texture_west.xpm
EA ./texture/texture_east.xpm

1111111111                        11111111
1000000001                        10000001
1000000001                        1000001
1000000101      111111            101111
10000000011111111000011111111111111011111111111111111111111111111111111111111
1110000N030000000000000000000000000000000000000000000000000000000000000000001
10000000011111111000011111111111101111111111111111111111111111111111111111111
1100000011      111111         1001111111111111
1000001001                     1000000000000001
1010101001                     1000000000000001
1010111001                     1000000000001111
1111111111                     1111111111111